Experiment: average-0.65-none-0
sub-buckets=19665
aa
- aa: aa
abednego
- abednego: abednego abdenago abednago abendego obednego
- abednigo: abednigo bendigo abendigo
accursia
- accursia: accursia accursio
adam
- adam: adam adamus adami adams adamo adamum adame addam adamina adamy adamss adamine adomas adoms adem adamis adma adom adamacio adm addams adames adamas adamm adnet adamii addame
- adan: adan adao adanto
- aidan: aidan aatu aadam
- aatami: aatami
- dahm: dahm
- edem: edem edam
- atam: atam
ado
- ado: ado addo
affred
- affred: affred
aguero
- aguero: aguero
ailsa
- alisa: alisa alissa
- ailce: ailce ailsa ailse ailsie ailsy
- alsa: alsa alsia
alastair
- alastair: alastair alasdair
alexander
- alexander: alexander alexandre alex alexr alexis alexandro alexandrine alexo alexius aleksander alexina alix alexandria alexa allexander alexey alexand alexandri allexr alexos alexandrino aleixo alexandr alexia elexander alexine alixander alaxander alexanderina alexi aleix alexsander elex alixe alexie alxr alexan alexandru allex alexandar alexei elix alexandrovna alexandros alx alexii alesander alexanda alexdro alezander alexy alexio alexios alexandrum alexande alxander alexd alax alexender allexis elixia alexando alexena alamander alexej aleander alexus alexader alexer alexandrea elixa alexandrinha allixander alexandera alexn alexe aexander allexsander alexandrus alexandrew alexanderine allxr alexendre elaxander alexes alexanderia elexis alexnder alexro alexandrie alexandor alexanders alixsander elixander alexice alexder alexandrin alexix alexaner alexzander alixis alexandia alexas elax alexandine alexana allexand elexious elexia alexious alexenia alenander alexs alaxender alexnader alcander alexamder allexandr alexzena alexandere alexcander alescander alexendra aleseander alexar alecander elexus elexius ellexander alexsis alixandr alexene alexandeer alexcis alixa alexandrius lexius lexander aleaxander alexiae elleander
- sandor: sandor sandra sandy sanders sander sands sandro sand sandrina sandi sanda sandie sandrine sandys sande sanderina sando sandert sandre sandry sandes sandorne sandia sandee sandar sandria sannes sanderijntje sandrijntje sandrijna
- alejandro: alejandro alessandro aleksandrovna alesandro alegandro alijandro allesandro allessandro alefandro alisandro aleksandro
- alejandra: alejandra alexandra aleksandra aleksandr alessandra alegandra alexdr aleksandras aleksandrs aleksandar alexsandra alajandra elexandra allesandra alixandra allessandra
- alexandrina: alexandrina alejandrina alessandrina alixandrina aleixandrina
- aleja: aleja alejos alejando alejandria alejanda alejandri
- alcantara: alcantara
- alec: alec alic elec
- saunders: saunders sunday saundra sunderland saunder sunder sunda sundra sundre
- aleksej: aleksej aleksei aleksi alek aleks aleksis alekso
- aleck: aleck alick allick alleck allec alack
- santi: santi santora santura santeri santy santie
- alejandrino: alejandrino alejandre allexandre alixandre allexandrine alxandre alejandrin alxandrine
- alessio: alessio alesio alesr
- sondra: sondra sondre xander sindre xandra sindry
- aleksanteri: aleksanteri
- alistair: alistair
- zander: zander sender senda seander
- scheindel: scheindel
- oksana: oksana aleksiina
- sondergaard: sondergaard
- alaster: alaster alr
- alego: alego alega alegos
- leszek: leszek
- alijo: alijo aljo alojo
- sascha: sascha sacha
- shandy: shandy shanda
- zandra: zandra
- olesia: olesia
- elwick: elwick
allena
- alene: alene aleen aleene alenia aliena aleena aleana
- ulyana: ulyana uliana ulan ulena ulene
- alleyne: alleyne alyene
- allena: allena allina ellana allenna
- illena: illena olanna
- yelena: yelena
- eulene: eulene euline eulena
alred
- alred: alred elred ellred
- aller: aller alar
alyandro
- aleandro: aleandro aljandro alyandro
- alyandra: alyandra
amby
- amb: amb amby amba ambo ambie
anara
- anara: anara anarah anariah
angiolino
- anjelino: anjelino angiolino angilo
ansgarius
- anasaria: anasaria anasario
- ansgarius: ansgarius
apple
- appleby: appleby apple apel appleyard
archel
- hercilia: hercilia hercelia
- arkley: arkley arshel arshal
- archel: archel archilla
arilda
- arild: arild arilda erilda urilda aurilda arelda
- urilla: urilla urella
- eurilda: eurilda
armour
- armour: armour armor armer armar
- ormur: ormur
artis
- ortis: ortis artis artus artist artice artes artois
ash
- ash: ash ashe
asmus
- asmus: asmus assmus osmus ausmus
athanasios
- athanase: athanase athanasio athanasius athanasios athanas athanagildo athanassios athanassio athanatius athanatious
- afanasij: afanasij
- fanya: fanya
aubierge
- aubierge: aubierge
austis
- austacia: austacia austa austasia austice austis austia austiss austic
aw
- yaw: yaw
- aw: aw
azubah
- azubah: azubah azuba azabah asubah asuba azubia asaba azaba azby azubiah auzubah
- zuba: zuba suba subia zuby suby
bainbridge
- bainbridge: bainbridge bambridge bembridge benbridge
bancroft
- bancroft: bancroft
barney
- barney: barney barnie barny barni bardney
- born: born bourne bourn bornie borne borney
- bjarni: bjarni borni biarni baarni biarne biarna bjarna
- birney: birney
bathilde
- bathilde: bathilde batilde
- bothild: bothild bothildur
- bathilda: bathilda batilda bethilda betilda
beatman
- bateman: bateman batman beatman
belarmina
- belarmino: belarmino belarmina bellarmina bellarmino belermina bellarmin
- belorman: belorman
benansia
- benansia: benansia
beriah
- beriah: beriah barah bariah buriah
- bera: bera bura
- byra: byra byre
bethel
- bethel: bethel bethuel bethell bethal bethnel bethial betheul bethiel bethewell bethewel
- bothwell: bothwell
- bythel: bythel bithel bythal
- bethula: bethula bethual
bickerstaff
- bickerstaff: bickerstaff biggerstaff
biscoe
- bosco: bosco biscoe boscoe
blaylock
- blalock: blalock blaylock
boaz
- boaz: boaz boas baz boase booz boes
bonifacio
- bonifacio: bonifacio bonifacia bonifasio bonifasia boniface bonifacius bonifaz vonifacio vonifacia bonifatius bonifazius bonefacio bonifazio bonificia bonefacia bonafacio bonifacy benifacio bonifaci bonafacia bonfacio bonificio bonifac benifacia bonfacia bonifacii bonefacius vonifasio bonifas bonifaco bonofacio bonefaas bonefaes
- boney: boney boni bonno
botterell
- bottrell: bottrell botterell
boynton
- boynton: boynton ponton pointon poynton
- boyington: boyington
bregje
- bregje: bregje bregtje brechie brechje breghie bregie breghje bregtie bregjen breckje brecktje
- brecht: brecht brechte brechtgen
brogan
- barragan: barragan
- brogan: brogan brogun
brynte
- brinton: brinton brunton
- brynte: brynte
bunell
- bonilla: bonilla bonel
- bonnell: bonnell bunnell bunell bonnel bunnel
bushrod
- bushrod: bushrod
cader
- cater: cater cader cator cador cadar
- kater: kater
calletana
- calletana: calletana calleta calatina
canales
- canales: canales
carabel
- corabelle: corabelle corabell corabel carabelle carabel carobel
carson
- carson: carson corson carsen corsen coursen karson
- corsino: corsino corcino corsina corcina
- curzon: curzon curson
- carshena: carshena
cathane
- cathen: cathen cathain cathane
- caethano: caethano
celerino
- celerino: celerino
- selerino: selerino
chabes
- chabes: chabes
chane
- chen: chen chuan cheney chien chino cheyne cheyenne chian chinn cheyney cheny channey chune chine chena chene cheeny chunn chiney chiny cheaney chiene cheeney cheyann
- chan: chan chaney chane chanie chany channie chain chainey channe chaine chani
chavez
- chaves: chaves chavez chavis
chick
- chick: chick choque
chona
- chin: chin china chon chona chonita chone
cirino
- cirino: cirino cirina ciriano
- cirenio: cirenio
- sirino: sirino sirineo cirineo
claude
- claude: claude claudean clude claudeen cloude claudes cluade clouide
- claudine: claudine claudina claudin claudinette claudionor claudinne claudene claudinae claudiane claudinete
- claudia: claudia claudiae clodia cladie clatie cladio cladia clodie clade clady clode clod clad clodio clada claddie
- claudio: claudio claud claudius claudie claudino clauda claudon claudii claudy claudiana claudis claudiano claudaz claudi clodius claudus klaudius claudianna claudious claudium claudo cladius claudias claudeus claudies claudeous
- claudette: claudette claudete claudotte claudot claudet claudetta
- klasina: klasina
- klavdiya: klavdiya
- cloud: cloud klaudine klaudia glaudine glaudina cludia klaudie cloudia cloudius
- clydia: clydia clida
- claudemira: claudemira claudemiro
- claudelina: claudelina claudell claudel claudelle
- cloda: cloda
- glodine: glodine
- chloda: chloda
- dinet: dinet
cline
- cleon: cleon clen clean clenn clayon clynn clyn
- cline: cline clin clinie
- klein: klein kline kleijn klin klen
- cleone: cleone clan clyne clain clane claine clayne
- calina: calina caline calline caoline calena calonia calene
- cloan: cloan cloene
cobus
- cobus: cobus kobus cobes kobes
collinson
- collingwood: collingwood collinwood
- collinson: collinson collison
concurrance
- concurrence: concurrence concurrance
coot
- coot: coot coote coots
corydon
- corydon: corydon coridon corridon corodon coryden coridan carydon
- carden: carden cordon cardon cardin corden cordin coradon
- corrydon: corrydon
cozbi
- cosby: cosby causby cosbie
- cozbi: cozbi cosbi
cripps
- cripps: cripps
cruikshank
- cruickshank: cruickshank cruikshank crookshank
curusa
- curusa: curusa curuza
- crusa: crusa
dabney
- dabney: dabney abney dobney
dameron
- dameron: dameron
- demarion: demarion
dart
- duarte: duarte duard duward
- dardo: dardo dart darth
- douard: douard
dco
- dgo: dgo dco
deirdre
- deirdre: deirdre diedre dierdre
delvoir
- delfor: delfor delvar delvoir
depew
- depew: depew depuy dupee
detroit
- detroit: detroit
dice
- dice: dice dis deis
- doyce: doyce
dilworth
- dilworth: dilworth delworth dellworth
ditlev
- detlef: detlef detlev detlof ditlef detleff dethloff dethlef dethlof ditlof dettloff dettlof delf detler dettleff dethleff dettlef ditloff ditleff dietloff detlif dithlef detloph
- ditlev: ditlev ditlov ditlevine ditlew ditlow
doe
- doe: doe doo does doa
donna
- donna: donna donalee donnalee danalee
- dona: dona donia doni donah donatha donya donea
- dawna: dawna duna dauna dauney
- donagh: donagh
douthet
- douthit: douthit douthet
drury
- drury: drury drewry drewery drewy druey druie druery drura druary drewrey dreury
duifje
- duifje: duifje duijfje duifke
durward
- durward: durward derward dorward darward
eardley
- eardley: eardley eardly
- yardley: yardley yeardley
eddley
- eddley: eddley eddly
eduvige
- eduvige: eduvige eduvijes edubije eduvigen edubijes edubigen edubigis edubijen eduvijen eduviga edubijis eduvigia eduvigio eduvejes eduvigue eduveges eduvigas eduvegis
- eduvvigis: eduvvigis eduvviges yduviges ediviges edoviges
- heduvige: heduvige eduvvige ydubije yduvige hedubige euduvige
- eduvirgem: eduvirgem
- ydubigen: ydubigen heduvigen
- heduvije: heduvije yduvijen
egene
- egenio: egenio egene
eizo
- eizo: eizo
- ezoa: ezoa ezoe
eleuterio
- eleuterio: eleuterio eluterio eleoterio elauterio elueterio eleutero electerio euluterio euleuterio eleutaria eleutario eleutorio elusterio eleucterio
- eleuteria: eleuteria eluteria eleutherio eleutheria elauteria eleuto eleuthere eleuta euleuteria eleutera eleuthera
elisaeus
- elisaeus: elisaeus eliseus elisus
- elises: elises
elmeda
- elmeda: elmeda elmetta elmeta elmedia elmida elemeda
eltham
- elth: elth eltham elthan
emich
- emich: emich emig
- amick: amick emmick
endris
- endres: endres endris endriss enderis endrine
entiquio
- entiquio: entiquio
eraclio
- heraclio: heraclio heraclito heracleo eraclito
- eraclio: eraclio eraclia eracleo
errett
- errett: errett eretta erett erret erretta
- erato: erato
- arat: arat
esmenegildo
- esmenegildo: esmenegildo esmenegilda esmenejildo esmenejilda
estes
- estes: estes estus estis estesia eastes
eudalia
- eutalia: eutalia eudalia eudal euthalia eude eudalie
eurebio
- eurebio: eurebio
evalee
- evalee: evalee eval evalie
- eveleigh: eveleigh
evodia
- evodio: evodio evodia
- evada: evada
ezechias
- ezequias: ezequias ezechias
fajardo
- fajardo: fajardo
farrow
- faria: faria fara faro farah farrah farra farrier
- farrow: farrow furrow
fedencio
- fedencio: fedencio
femmetje
- femmetje: femmetje femmetie femmitje femmetjen
festus
- festus: festus vestus festy festes
finbarr
- finbar: finbar finbarr
fitzwilliam
- fitzwilliam: fitzwilliam
floripes
- floripes: floripes floripa
foon
- fiona: fiona foon fuen
fox
- fox: fox faux foxe
- folke: folke falk fokko foulk fulke fulk foulks folk faulk falck fooks folkes folks falko fouk faulke fulks falkert faulkiner
- focke: focke foulkes foulke foolke fouche fowke fowlkes fowlke fowkes fouke foelcke
- falco: falco fulco folco fulconis faulcon facco
- foulques: foulques fouques
- vollig: vollig
- volkier: volkier
frideborg
- frideborg: frideborg
fuensanta
- fuensanta: fuensanta
gad
- gad: gad gade gadd gaddy gat gadi gaudin gaud gada gaudy gawdy
gamewell
- gamewell: gamewell gamwell
garside
- garside: garside gartside
gebhard
- gebhard: gebhard gebhart gebhardt gebhardus gebert geverd gebbard gebart gebh gaebhart
genisa
- genisa: genisa
gerbrand
- gerbrand: gerbrand garbrand gerbrant garbrant gerbrands gerbrandus gerbrandt gerrebrand gerrebrant garrabrant gerbrants garbrandt
- gerbrecht: gerbrecht gerbrig gerber gerbert gerbrich gerbregt gerbrigje gerberich gerbreg gerbrechta gerbrech gerbregje gerberig gerbrigh gerbrechtje gerrebrecht gerrebreg
gettrudis
- gettrudis: gettrudis getruds
gijsje
- gijsje: gijsje
giok
- giok: giok
gizzur
- gissur: gissur gizur gizzur
gloe
- gloe: gloe gloy gloye
golig
- golig: golig giolig
gormlaith
- gormley: gormley gormly gormlaith
gppe
- gpe: gpe gupe gp gppe gppa
greijtien
- greijtien: greijtien greitien
- grijetgen: grijetgen
gs
- gs: gs
guglielmo
- guglielmo: guglielmo guglielino
- guglielmi: guglielmi
gundel
- gundel: gundel gundhild gundula
- gandolfo: gandolfo gandolfa
guttorm
- guttorm: guttorm gutorm guthorm guttormur guther guttorn guttor
hadar
- hadar: hadar hader
haley
- haley: haley hally haly
- haralda: haralda heralda
hampshire
- hampshire: hampshire
haring
- haring: haring haringh
harvard
- harvard: harvard harver
- hereford: hereford harward herward
- arvard: arvard
haviland
- haviland: haviland havilland haveland
heber
- heber: heber hebert herbor haber habor
- eber: eber ebert ebbert eberd ebber ebor eberts
- eubert: eubert
- ivarr: ivarr
helty
- heladia: heladia heltje helty
- hiltie: hiltie
heraclia
- heraclia: heraclia
hesper
- hesper: hesper hesperia
higdon
- higdon: higdon higden
hilmer
- hilmer: hilmer hilmar hillmer
- hilgerus: hilgerus hilgeri hilgero hilgerum hilgert
- hilliger: hilliger heilger hillger
hkan
- khan: khan
- hkon: hkon hkan
holje
- holje: holje holge halje
- hlje: hlje
honywood
- henwood: henwood honeywood honywood
hospicio
- hospicio: hospicio hospicia ospicio hospecio
ht
- ht: ht
hunter
- hunter: hunter hunt hunts
hyman
- hyman: hyman himan
idena
- idena: idena idina idna idana
ilene
- ilene: ilene ileen ilena ilean illene ileene
- ailene: ailene
impje
- impje: impje impie
ingram
- ingram: ingram ingraham ingelram inghram engram ingeram ingrum ingrame ingrami
- ingracia: ingracia
- ignora: ignora
iredell
- iredell: iredell iradell iredale irdell iradel iredel
isidio
- izidio: izidio isidio isidia
ivadell
- ivadell: ivadell ivadelle
jacob
- jacob: jacob jakab jakub jacobje jacobse jocob jacobss xacoba jekabs jokubs jacub jokob jachob jacab jacobz jaccob jacobie jekub jacobb jabob yakob yacob jaacob jocubs jacabo jaakob gacoba jakuba iacob yakub jacb jacubus yacoub jocab jacobita jecub jacaba jocobina jacuba jagob jokub jcob jacabina yacub jecob joacob jekob jacco kacob
- jakob: jakob jacobi jacoby jakobi jakoby jakol jakli
- jacobus: jacobus jacobs jakobus jacobsz jakobs jacobis jacobes jaks
- jacques: jacques jaque jacquelina jaquemine jacquelline jacqz jacqus jacqui jacquema
- jacoba: jacoba jacobea jakoba jacobae jakobea jacobia jacobaea jakobia jacobeae jacobaa jacobeam jakobaea
- jacobo: jacobo jacova jacop jaco jacopo jacovo jakop jakup jackop jakoc
- jacobina: jacobina jacobine jakobine jakobina jacoben jacobee jacobena jacobin jacobbine jocobine
- jacobum: jacobum jacobam jakobum
- jaakko: jaakko jb japik jaako japick jk jek jacok jalke
- jacobsen: jacobsen jakobsen jacobson
- giacomina: giacomina giocoma
- jacobe: jacobe jaepje jakobe jaepie
- iacopo: iacopo
- jackob: jackob koo koba koob kobe jackobina
- korbinian: korbinian corbinian
- jogli: jogli joggi jaggli jaggi joggli jog joggeli jagi jogeli jaegli jogi jaggeli jaagli joglj jaglj jaeggli
- joka: joka
- jacoff: jacoff jocoff jacof jocof
- yeghia: yeghia
- jeep: jeep jeaque jeip
- jacobii: jacobii
- jacobos: jacobos coosje
- jachet: jachet
- sjaak: sjaak schak
- jaqua: jaqua jacues jaquis jagues
- jaagup: jaagup
- cobie: cobie coob copa
- jackle: jackle jackli
- jacomia: jacomia
- jaymee: jaymee
jannetgen
- jannetjen: jannetjen jannetgen jannetge jannetije jantgen
jeacques
- jeacques: jeacques jeaques
jenkins
- jenkin: jenkin jenkins jenkinson jenkyn jenken jinkins jinkin junkin jenckin jenking jenkini jenkine jenkens jankin jeken jenkinge jinken
- jonk: jonk
jertru
- jertru: jertru
jhs
- jhs: jhs
joel
- joel: joel joella joell joelle jole joeli joellen joal jol jolle joll joil joela jowell jowel joels joellyn joele
- jeol: jeol
- yoel: yoel
- johiel: johiel johel johial johile jaiel
joris
- joris: joris jors jores jorus jorise jorisze
- jooris: jooris
jovino
- jovino: jovino joventino joviano jobino
juho
- juho: juho
kader
- katr: katr kader
- kidder: kidder
- kedar: kedar kadar
kay
- kay: kay kai kaye kaja kaia kae kaw kaio kaie
- cai: cai cay caio caius caw cau cae
- ke: ke kei ky keay kej
- ceu: ceu
- chay: chay
- cajus: cajus gajus
- schaje: schaje
- kaylynn: kaylynn kaylyn
kendra
- kendrick: kendrick kindred kinder kendra kendrew kendred kendricks kindrid
keturah
- keturah: keturah katurah ketura katura kitturah kiturah catura kittura ketturah kitura caturah ketorah keturiah kuturah kutura
- kittury: kittury
kimer
- kamer: kamer
- kimer: kimer
kisire
- kisire: kisire kissire kizirah
knudsen
- knudsen: knudsen knudsine
kune
- kuno: kuno kune kuen kunneke
- kunnigje: kunnigje kunnigjen
lael
- lal: lal lael lale lail laleah lall
lamont
- lamont: lamont lamon lamond lamonte lemont lemond lamonde lemonte
- layman: layman leyman
- laymond: laymond limond lomond
- lament: lament lamount lamant
larmon
- larmon: larmon larman
lauritsen
- lauritsen: lauritsen lauridsen
- laritz: laritz
lazaro
- lazaro: lazaro lasaro lazzaro lacaro lozaro lassaro laso losaro lasi
- lazara: lazara lazarus lasara lazare lazar lazard lazarine lasarus lazerus laz lasar lazarina lazarre lazario lazari lazrus lazurus lazzara lazaros lazaras lasaria lazarius lazarous lasare lazuras lazaris
- leiser: leiser laser leeser leazer
- lazarette: lazarette lazareth
- lesario: lesario
- lizar: lizar
- lzaro: lzaro lzara
lefa
- foy: foy foye foyer
- leva: leva levke
- leafy: leafy leaf lefa leafa leafie leffie leafe leefe lefoy lefy lefee leaffy lefey leaffe leafee
lemon
- lemon: lemon leman lemoyne lamoine lemoine lemmon lamoyne lemoin lemen lamoin lemons lemona lemonia lemmons lemin lammon lamaun lemaun
- lumina: lumina lumena
- lehman: lehman leamon leeman leaman lehmann leemon lehmon leiman
- laman: laman lamen lamone
leser
- lizer: lizer
- leizer: leizer lesser lesher leser
- lazer: lazer lasher
- leasure: leasure
libbens
- lobban: lobban libbens
lillian
- lillian: lillian lillie lilian lelia lilla lilia lillia lilley lilie liliana lilli lili liliane lille lilliam liley lilo lill lillah lillan lilianne liliam lylian lillien lelian lilllian lillion lilliane lilliana lilio lillin lilien lyllian lillen lillianne lillain lellian lillean lilean lilion lilliann lilianna
- lily: lily lilly lilyan lillyan lillye
- lila: lila lilan
- leila: leila leal lellie leala lelie leilah lelina leilia leilla lealia leile lely lelly leil lel lellen leiel leline
- laila: laila lallie lalia lally lalie laly
- lyyli: lyyli lylie lyly
lira
- lira: lira liria lirio lirrie
llagas
- llagas: llagas
- lagos: lagos lajas
loflin
- loflin: loflin lofland
lorelda
- lorilda: lorilda larilda lorelda larelda laurelda
- lurilda: lurilda
lovetta
- lovett: lovett lovetta lovette loveta lovet lovatt lovitt lovat lovita lovit loved lovid
- leavitt: leavitt leavett
lucretia
- lucretia: lucretia lucrecia lucrezia lucetta lucresia lucrece lucette lucrecio lucresse lucreta lucretta lukretia lucritia loucretia lacretia lucricia lucretiae lecretia lucresio lucrecy leucretia lucrettia lucresa lucretie lucrese lucreatia lucres lucretius lucressia lucratia locretia lucertia lucrelia lucris lucras lucrita lucresy lucettia lucreita lucretea lucreasy luceretia lucresha lucreia lucreece lucrectia lucrets lucratus lucressa lucreacy lucrica lucrisa lucutia lucrtia lucretin lucretis luceretta luct lucresey lucreasey lycretia
- lugrezia: lugrezia loucrecia leucrecia
- luerecia: luerecia lutrecia
- lukris: lukris lukresia lokris lukrits
- loucetta: loucetta lycetta
- cretta: cretta
- setti: setti
- lucrieta: lucrieta
lugo
- lugo: lugo luardo lug luigo lugdo
- leard: leard luard louard
- lard: lard
luttrell
- luttrell: luttrell latrell littrell
lytton
- litton: litton lytton litten lighton
- leaton: leaton leeton
- leton: leton
madison
- madison: madison madsen mattison matson mattson matheson maddison mathieson matison mathewson mathisen madson mathison matteson maderson mattinson madeson mathiason madderson maddeson
- medicine: medicine
- matzon: matzon
maijke
- maaike: maaike maijke maaijke maijken maike mayken maeijken majken maeijke maeyken maayke maaijken maaka maeyke maeike meyke maayken majke maeke maeiken mayka
- maika: maika maik maicke maicken maichje
- maijcke: maijcke maijcken maycke maeijcke maeijcken
- maijgje: maijgje maaijgje maijtje
mamerto
- mamerto: mamerto mamerta mamert mamet
manta
- manta: manta mantie mant mantha mando mantje manti
- menta: menta mentie mentha menty
- munthe: munthe
- mayant: mayant
marina
- marina: marina merina marinah myrina
- marine: marine marinka marinho marinha marini morine marinna marrin marain maroin
- maryna: maryna mariena
- marena: marena morena morina mareno morino marenia
- mereana: mereana merehana
- marana: marana maranna morana merana maranah murana
- mariona: mariona
- myrene: myrene merena mirena merene
- merran: merran meren merania marania
- marimo: marimo
- marrina: marrina almarina
- marijntje: marijntje
- almarene: almarene almarena
- myrnia: myrnia
marvella
- marvel: marvel marvella marvell marvelle mervel murvel marval morvel
- marybelle: marybelle marybell marybel
- marzella: marzella
- merville: merville mervil marvilla marvil marville marvill mervilla
- maravillas: maravillas
- marwell: marwell
matisa
- matiaz: matiaz mateasa matisa matisha
maywood
- maywood: maywood
mcintosh
- mcintosh: mcintosh macintosh mackintosh
- mcintyre: mcintyre
medad
- medad: medad midad
melcena
- melcena: melcena melson melsen melsena melcenia malcena melissente
- melcina: melcina melzina melzena melsina malzena malcina melcinia
menelaos
- menelaos: menelaos
merlin
- merlin: merlin murlin myrlin morlin
- merlyn: merlyn merlynn murlyn
- maryland: maryland merland murland murlen myrland myrlen myrlan
- merlene: merlene merlen merleen
- merline: merline murlene myrlene murline myrline myrleen
- merlon: merlon merlina merlan
mgr
- mgr: mgr
milam
- milam: milam milliam milum miliam milham
- mallam: mallam
mindel
- mindel: mindel mintje mindla
mj
- mj: mj
montague
- montague: montague montagu montaque montegue montigue mountague monticue montacute
morman
- merriman: merriman merryman merman
- moorman: moorman
- morman: morman mormon marmon
mozelle
- mozelle: mozelle mozell mozella mazel mazella mazelle mozel mazell mazilla mizella mazle
- moselle: moselle mosella mosell mosel
- mizael: mizael
- maysel: maysel maysell
- moiselle: moiselle mocella
muss
- moss: moss
- muse: muse muus mus muss muijs muis muos
- moussa: moussa
nair
- nair: nair nahyr
- nar: nar
nason
- nason: nason nassan naasson naason
- nison: nison nissan nisan
neff
- neff: neff nefi nf
nerius
- nereus: nereus nerius nerias
newman
- newman: newman naaman neuman namon neumann numan naman nyman niman naamon nahman
- newnam: newnam
nicomedes
- nicomedes: nicomedes nicomedis nicomedez nicomede nicomeda nicomedia nicomedo
- nicodemus: nicodemus nicodemo nicod nichodemus nicodemas nickodemus
- nicudemus: nicudemus nicudemos
- necomedes: necomedes
nissen
- nissen: nissen nishan nissim nussen
nonda
- nonato: nonato nonata nonnato
- nondus: nondus nonda
noyes
- noyes: noyes noyce noise noyse nois noys
obera
- ober: ober obera oberia obery
odilon
- odilon: odilon odilona odelon odlin odiln
oh
- oh: oh
olga
- olga: olga olgar olka olgie olge ulga olaga
- olegaria: olegaria
ona
- ona: ona onnie onia onna ony oni onas onny onah onea oona oena oana
- una: una unni und une unie unna uni unia unah uny unnie uney unj
- yona: yona
- onnolee: onnolee
orange
- orange: orange orrange orenge
ormond
- ormond: ormond orman ormand ormon ormund ormando oramon
- tormund: tormund thormund tormond
oses
- oses: oses
ottiwell
- ottiwell: ottiwell otwell ottewell ottwell ottowell otiwell otewell
- ottual: ottual
oxley
- oxley: oxley exley loxley
paiva
- paiva: paiva
pantha
- panthea: panthea pantha panthia
parthena
- parthenia: parthenia parthena parthina perthena perthenia partheny parthinia parthene part partha parthania pertina parthana porthenia porthena parthine parthema perthina paratine parthemia parthenea parthia partina partheney perthana partenia parthonia perthema
- purthenia: purthenia pearthenia
patton
- patton: patton paton patten paten patent patin
- peton: peton petten
ped
- ped: ped pedo
- pd: pd
pennock
- pennock: pennock penick pinnock
perina
- peronne: peronne perinne perrinne pierronne pierrone
- perina: perina perona perena parina pering perrina parena
- piron: piron pyrena pirena pyrene pirene pyrenia
- pherina: pherina
peyton
- peyton: peyton payton payten
philura
- philura: philura philora philury
- phillury: phillury
pilar
- pilar: pilar pilara pelar pillar pilr
plantaganet
- plant: plant plantagenet plantaganet
polaski
- pulaski: pulaski polaski palaski
- pilas: pilas
porfino
- porfino: porfino porfinia porfinio
preben
- preben: preben praben
pritchard
- prichard: prichard pritchard pritchett prichd prichett pritchet
ptronille
- ptronille: ptronille
quaid
- quade: quade quaid
race
- race: race rase
- rayes: rayes
ramosa
- ramosa: ramosa ramusa ramoz
rauha
- rauha: rauha raha
redfern
- redvers: redvers redford
- redfern: redfern redfearn
reinoud
- reint: reint
- ryno: ryno
- reinoud: reinoud
renato
- renato: renato renatus renaat renati
- renardus: renardus
- reynato: reynato
- reneer: reneer
revd
- revd: revd
ridge
- ridge: ridge ridgely ridgley ridgeley
- redge: redge
rinne
- rinne: rinne rinear
roark
- roark: roark rorick rorik
rojas
- rojas: rojas
rosabelle
- rosalba: rosalba rosealba
- rosabelle: rosabelle rosabel rosabella rosabell rosebell rosebelle rosebella roseabelle
- rosaville: rosaville
rowena
- rowena: rowena roena roan roanna rovena roana rowene rowina roann roene roenna roina rowana roine rowenna rohanna roenia rovene rovenia rowanna rovine rohana roannah rouena roween rowine rowann roaney roeanna roeny rowane royann rowennah
- ruan: ruan ruina ruvina ruvinia ruhene
- rona: rona ronna
- rhona: rhona rhoena rohena rhoana rhuana rhoanna
- rovina: rovina revina ravina
- ravena: ravena revena ravenna rauna rawn
- rivannah: rivannah
ruliff
- ruloff: ruloff ruliff rulif ruluff ruluf ruleff
ruurtje
- ruurdtje: ruurdtje ruurdje ruurtje
sagrado
- sagrado: sagrado sagrada sagrados lagrado sagrdo
sample
- sample: sample samples
- semple: semple
saraiva
- saraiva: saraiva
saverio
- severo: severo cevero severio sevaro
- saverio: saverio saveria sayer sayers savory savery savario savaria savary savera savero saver savira saier
- syer: syer
scholastique
- scholastique: scholastique scolastique cholastique
- scholastica: scholastica scolastica scholastika scholastyka skolastika scholast scholasticae colastica scholastic scholasticka skolastica scholastina
- schol: schol
sears
- sears: sears searcy sejer seier sier sear seyer seir sejr seer syers seers seare
- saer: saer
seiko
- eiko: eiko seiko
- sieka: sieka cieke
senora
- senor: senor seiner
- senora: senora sedora senoria cenora sinora senorah cenoria
- senorina: senorina cenorina
- cenira: cenira cener
- sanra: sanra sanora
- zenora: zenora zenorina
setrak
- setrak: setrak
shanner
- shiner: shiner shanner
sherman
- sherman: sherman sharman shearman shermon shurman sherma sharma sherm sharmon
- surman: surman sermon
shriver
- shriver: shriver schriver
sieuwtje
- sieuwke: sieuwke sieuwtje
- seitje: seitje seytje
sila
- sil: sil sila sill sile silah
- scilla: scilla
- cyle: cyle
- zial: zial
sinforosa
- sinforosa: sinforosa sinforoso sinforoza simforosa simphorosa sinforozo sinphorosa simforoso cinforosa symphorose sinforasa
- sinforiano: sinforiano sinforiana sinforeano simforiano simforiana
- symphorienne: symphorienne
- simporosa: simporosa
- sinfrosa: sinfrosa simfrosa sinfroso simfroso
- sinforeana: sinforeana
sjoerdtje
- sjoerdtje: sjoerdtje sjoerdje sjoertje sjurtje
slocum
- slocum: slocum slocombe
society
- society: society
sonora
- sonora: sonora sonorah
- snorri: snorri snorre snorra
sp
- sp: sp
sproul
- sproul: sproul spruell
stansbury
- stansbury: stansbury stanbury stansberry stanberry
stephen
- istvan: istvan estavan esthevan estivan esttevan eztevan
- stephanus: stephanus stephan stephani stephano stephania stephane stephana stephanum stephany stephans stephann stephanis stephannus stephanos stephanius stephanes stephanns stephanas stephannes
- stephen: stephen steph steve stepan stevenson stephens stepha stephenson step steeven steuen stevan steva stephn stevie steephen stepn stephus stepney steaven stephina stephin stepen stevin steban stephi stephine stevo stiven stephon steyn stephenus stephe steaphen stephnus staphen steave stephena stephensen steeuen stepheni stphen steuben steeve stev stepp stevyn stean stephney stevanus stephyn stepehn steevens steauen stovin stee stiphen stevon sthephen stepheny steiven stehen stephne stewen stepehen stuben stpehen stephson stehpen stuen stevi steohen stephenas stp
- esteban: esteban estevan estevao esteve estevam esteves estaban esteba estevn estiban esteuan estteban estev estvan esteven estevo estebn esteben estebam ezteban estban estebe estebon estoban estevenon
- etienne: etienne etiene ettienne ethienne etien etten ettiene eteinne hetten eitenne
- steven: steven stevens steventon
- stefan: stefan stefano steffen stefanus steffan stefana stefanie estefano steffano stef stepanus stefen stefani stefa steffens stefo steffanus steffine steff steffie stefanos steffani stefanja stefane steffe stefaan stefanis stefon steffin steffann
- stephanie: stephanie stephenie stephie
- staffan: staffan stjepan stipan staffen stafan staf stepfan stiepan stafano staeffen staffans staeffan
- szczepan: szczepan
- staphan: staphan staphanus steaphan stphanie
- tapani: tapani
- tahvo: tahvo
- sephen: sephen sephan
- estheban: estheban hesteban
- estephano: estephano estepana
- istuan: istuan
- steponas: steponas
- stebbing: stebbing etting
- heton: heton
- sophonius: sophonius
stoker
- stoker: stoker stocker staker
stylianos
- stylianos: stylianos stelios stilianos
sussman
- sussman: sussman sassaman
sweetland
- scotland: scotland sweetland swetland
ta
- ta: ta tah tau tia tta
talmage
- talmadge: talmadge talmage talma tallmadge
- tollemache: tollemache
tarje
- tarjer: tarjer tarje taras targje
- terje: terje tergie
teadore
- teadore: teadore
tennessee
- tennessee: tennessee tennesse tennesee tenessee tennys tennissee tennessie tenisee tenneessee tennysee
texas
- texas: texas texa
theoderick
- theodrick: theodrick theodric theoderick theoderic
- tederico: tederico
thorine
- thrine: thrine thorine thorne torine thorunn thorn thrina thorun thoren thorny thorunar thorunnar thodorine
- tormo: tormo tormoe thormo
- therina: therina therena threna
tiaerd
- tier: tier tiaerd tieert
tilton
- tilton: tilton
- talton: talton
tivadar
- tivadar: tivadar
toebke
- tobke: tobke toebke toebe
torcoroma
- torcoroma: torcoroma
town
- towne: towne town towns towner townes townend
trevanion
- trevino: trevino trevanion trevenen
truelove
- truelove: truelove trulove
tulip
- tulip: tulip
tyson
- tyson: tyson tison tysen
uler
- euler: euler eular ular uler ulery
unity
- unity: unity unita unetta unite uneta eunity unett unettie
ursula
- ursula: ursula ursule vrsula ursulae urzula ursola ursulo ursulina ursel ursus ursala urszula ursulam ursilla hursula ursulla ursela urcula ursa orsula ursulle ursul vrzula urssula ursla ursila ursley ursella ersula arsula vrsulae urschula urusla urso ursolina usula ursuline urselina urschla ursal ursua ursell ursi ursulah ursolo ursual ursely arzula ursulen urshula ursie urseley ursele urusula ursly ursilia urseline ursuley urssel urshel ursular vursula ursulay urseli ursulia ursulita ursuala urssla vrsulay ursuly urschel urzina uraula ursle ursaley urss versula eursula ursalla ursey urselle ursale ursalina urson ursalae erzula ursille urselah urseltje ursuls urs
- orzse: orzse orse orser
- orsola: orsola orsolina orsala orsilla orsel orsill orselina arsella orselia orzella orzelia orsla orsila orsella
- ercilia: ercilia ersilia ersa ersie ercie ercelle ercila ercilla ersilla erzel
- ursulino: ursulino urzulo vrsulo urzino urzulino
- vrsola: vrsola vrsala
- usley: usley usilla uzella ussala usly uschi ussilah uzilla ucilla ussela usala usla uorschla usaly ussly
- hersilia: hersilia hersilie
- ours: ours oerzse
- vrsel: vrsel vrseley vrcina vrsela vrsely vrsella
- urcilla: urcilla urcella urcela urula urcinia
- worssila: worssila worsila vrsilla vrsila aarsilla
- earsie: earsie
- vrsley: vrsley vrsly orsally
- thuring: thuring thuering
- vrsule: vrsule hursule
- durss: durss duri durisch durig
- arsilla: arsilla arsulla
- ouseley: ouseley
- oscilla: oscilla oscha
- arshalous: arshalous
- esula: esula
valdemar
- valdemar: valdemar waldemar waldermar waldmar valdmar valdermar waldamar valmar valdamar
- waldina: waldina valdine valdina valdean valden valdon valdene
- valdimar: valdimar
- veldon: veldon velden velde
- waldemir: waldemir waldemer
- wolmar: wolmar wolmer wollemar
- wallemar: wallemar
- woolmer: woolmer
vandyke
- vandyke: vandyke
vd
- vda: vda vd
ventura
- bentura: bentura
- ventura: ventura venturo venturina venter venture venturada ventur venturia
- vinter: vinter
vero
- vero: vero wero verro
- verisimo: verisimo
- virau: virau
- varro: varro
vida
- vita: vita vida vit veta vid vietta vido vidad vetta vitta vide vieta vidie vidah
- vada: vada vaudie vauda vata
- veda: veda vedia vedie veida vede vette
- witte: witte witta wita wida
vinther
- vinther: vinther
vittoria
- vittoria: vittoria veturia vituria
vrerick
- vrerick: vrerick vrerik
waldron
- waldron: waldron waldren waldram
- wildred: wildred
warfield
- warfield: warfield
wayburn
- wayburn: wayburn weyburn
wells
- wells: wells welles willes well wyllys willas wyllis wellis wels
wh
- we: we wh ww whh
wibbe
- wiebe: wiebe wijbe wibbe wibe wijbbe wibbo wiebo wijbo wibo
- wippert: wippert wipert
- weiprecht: weiprecht
- wijpko: wijpko
wijmke
- wimke: wimke wemke weim wijmke
- wemmigje: wemmigje
willetta
- willet: willet willett willette willets wilts willits willetts willit willitt willott williet
- willetta: willetta wiletta willeta willietta
- wilhite: wilhite
- waylett: waylett
wingate
- wingate: wingate winget
wmb
- wmp: wmp wmb
woodfin
- woodfin: woodfin
worthy
- worth: worth worthy wirth worthey wortha worthie warth
- werth: werth
wyndham
- wyndham: wyndham windham windom wyndam winham
yadwiga
- yadwiga: yadwiga
yeoman
- yeoman: yeoman yeomans yeaman yeamans
you
- you: you yoo
yuma
- yum: yum yuma yoma
zapopan
- zapopan: zapopan zapopa
zenith
- zenith: zenith zenneth
zlate
- zlate: zlate
zwaantje
- zwaantje: zwaantje swaantje swaentje zwaantien swaentien zwaantjen schwantje swaentjen swaantjen swaantien zwantje
- swaantie: swaantie swaentie zwaantie swantie
- zwenne: zwenne zwenneken
- swana: swana swanida